"filename", "language", "Markdown", "Lua", "comment", "blank", "total"
"c:\Users\edwar\OneDrive\Goomania\README.md", "Markdown", 7, 0, 0, 3, 10
"c:\Users\edwar\OneDrive\Goomania\conf.lua", "Lua", 0, 48, 0, 3, 51
"c:\Users\edwar\OneDrive\Goomania\libraries\class.lua", "Lua", 0, 74, 9, 16, 99
"c:\Users\edwar\OneDrive\Goomania\libraries\json.lua", "Lua", 0, 603, 182, 156, 941
"c:\Users\edwar\OneDrive\Goomania\libraries\push.lua", "Lua", 0, 219, 8, 54, 281
"c:\Users\edwar\OneDrive\Goomania\main.lua", "Lua", 0, 42, 10, 21, 73
"c:\Users\edwar\OneDrive\Goomania\src\constants.lua", "Lua", 0, 152, 6, 11, 169
"c:\Users\edwar\OneDrive\Goomania\src\dependencies.lua", "Lua", 0, 32, 1, 10, 43
"c:\Users\edwar\OneDrive\Goomania\src\gui.lua", "Lua", 0, 33, 6, 10, 49
"c:\Users\edwar\OneDrive\Goomania\src\stateStack.lua", "Lua", 0, 20, 0, 4, 24
"c:\Users\edwar\OneDrive\Goomania\src\states\confirmState.lua", "Lua", 0, 40, 2, 11, 53
"c:\Users\edwar\OneDrive\Goomania\src\states\inGameStates\attackState copy.lua", "Lua", 0, 104, 13, 32, 149
"c:\Users\edwar\OneDrive\Goomania\src\states\inGameStates\attackState.lua", "Lua", 0, 101, 14, 29, 144
"c:\Users\edwar\OneDrive\Goomania\src\states\inGameStates\battleFightState.lua", "Lua", 0, 57, 9, 13, 79
"c:\Users\edwar\OneDrive\Goomania\src\states\inGameStates\battleIntroState.lua", "Lua", 0, 48, 3, 14, 65
"c:\Users\edwar\OneDrive\Goomania\src\states\inGameStates\defeatState.lua", "Lua", 0, 18, 0, 6, 24
"c:\Users\edwar\OneDrive\Goomania\src\states\inGameStates\fieldExitState.lua", "Lua", 0, 22, 1, 6, 29
"c:\Users\edwar\OneDrive\Goomania\src\states\inGameStates\fieldMenuState.lua", "Lua", 0, 24, 1, 7, 32
"c:\Users\edwar\OneDrive\Goomania\src\states\inGameStates\playState.lua", "Lua", 0, 121, 10, 21, 152
"c:\Users\edwar\OneDrive\Goomania\src\states\inGameStates\saveState.lua", "Lua", 0, 23, 0, 8, 31
"c:\Users\edwar\OneDrive\Goomania\src\states\inGameStates\victoryState.lua", "Lua", 0, 16, 0, 6, 22
"c:\Users\edwar\OneDrive\Goomania\src\states\quitState.lua", "Lua", 0, 7, 0, 2, 9
"c:\Users\edwar\OneDrive\Goomania\src\states\tempStates\alpha.lua", "Lua", 0, 17, 0, 7, 24
"c:\Users\edwar\OneDrive\Goomania\src\states\tempStates\beta.lua", "Lua", 0, 17, 0, 7, 24
"c:\Users\edwar\OneDrive\Goomania\src\states\tempStates\integration.lua", "Lua", 0, 17, 0, 7, 24
"c:\Users\edwar\OneDrive\Goomania\src\states\textState.lua", "Lua", 0, 19, 2, 5, 26
"c:\Users\edwar\OneDrive\Goomania\src\states\titleScreenStates\loadSaveState.lua", "Lua", 0, 31, 0, 9, 40
"c:\Users\edwar\OneDrive\Goomania\src\states\titleScreenStates\mainMenuState.lua", "Lua", 0, 31, 3, 8, 42
"c:\Users\edwar\OneDrive\Goomania\src\states\titleScreenStates\newSaveState.lua", "Lua", 0, 35, 1, 8, 44
"c:\Users\edwar\OneDrive\Goomania\src\states\titleScreenStates\settings.lua", "Lua", 0, 20, 0, 6, 26
"c:\Users\edwar\OneDrive\Goomania\src\states\titleScreenStates\titleScreenState.lua", "Lua", 0, 40, 5, 17, 62
"c:\Users\edwar\OneDrive\Goomania\src\states\titleScreenStates\volume.lua", "Lua", 0, 49, 4, 14, 67
"c:\Users\edwar\OneDrive\Goomania\src\states\transitionStates\fadeInState.lua", "Lua", 0, 45, 0, 5, 50
"c:\Users\edwar\OneDrive\Goomania\src\states\transitionStates\fadeOutState.lua", "Lua", 0, 46, 3, 8, 57
"c:\Users\edwar\OneDrive\Goomania\src\states\tutorialStates\chooseGoomonState.lua", "Lua", 0, 37, 0, 10, 47
"c:\Users\edwar\OneDrive\Goomania\src\states\tutorialStates\introductionState.lua", "Lua", 0, 32, 0, 8, 40
"c:\Users\edwar\OneDrive\Goomania\src\util.lua", "Lua", 0, 42, 5, 10, 57
"Total", "-", 7, 2282, 298, 572, 3159